********************************
*..............................*
*..................m...........*
*.........*****................*
*..............................*
*.......................m......*
*..............................*
*..............................*
*.............p................*
*..............................*
*..............................*
*...........******.............*
*..............................*
*..............................*
*..............................*
*................*****.........*
*................*.............*
*................*.............*
*..............................*
*..............................*
*..............................*
*..........................m...*
*..............................*
********************************